State,Biodiesel,CNG,E85,Electric,Hydrogen,LNG,Propane,Total,Year
Alabama,11,3,6,0,0,0,40,60,2008
Alaska,0,1,0,0,0,0,10,11,2008
Arizona,10,40,23,5,1,5,51,135,2008
Arkansas,2,3,7,0,0,0,37,49,2008
California,36,184,13,376,26,28,199,862,2008
Colorado,18,18,65,0,0,0,43,144,2008
Connecticut,1,9,4,3,1,0,13,31,2008
Delaware,3,1,1,0,0,0,2,7,2008
District of Columbia,1,1,3,0,1,0,0,6,2008
Florida,12,15,18,3,2,0,47,97,2008
Georgia,28,18,28,0,0,0,37,111,2008
Hawaii,7,0,0,4,1,0,3,15,2008
Idaho,6,7,5,0,0,1,25,44,2008
Illinois,3,20,181,5,1,0,52,262,2008
Indiana,6,14,111,0,0,0,31,162,2008
Iowa,5,0,107,0,0,0,24,136,2008
Kansas,5,2,23,0,0,0,44,74,2008
Kentucky,1,0,11,0,0,0,13,25,2008
Louisiana,1,5,3,0,0,0,9,18,2008
Maine,5,1,0,0,0,0,8,14,2008
Maryland,8,14,12,0,0,0,13,47,2008
Massachusetts,5,11,1,12,1,0,21,51,2008
Michigan,17,13,60,0,7,0,69,166,2008
Minnesota,1,1,353,0,0,0,30,385,2008
Mississippi,5,0,2,0,0,0,33,40,2008
Missouri,5,6,87,0,1,0,65,164,2008
Montana,4,3,1,0,0,0,29,37,2008
Nebraska,3,2,35,0,0,0,18,58,2008
Nevada,12,11,16,0,2,0,28,69,2008
New Hampshire,11,3,0,8,0,0,11,33,2008
New Jersey,1,11,0,0,0,0,10,22,2008
New Mexico,7,11,8,0,1,0,49,76,2008
New York,5,92,17,1,0,0,30,145,2008
North Carolina,66,12,14,0,0,0,44,136,2008
North Dakota,0,2,30,0,1,0,13,46,2008
Ohio,24,8,64,0,0,0,66,162,2008
Oklahoma,6,51,6,0,0,0,64,127,2008
Oregon,36,12,8,15,2,0,29,102,2008
Pennsylvania,7,25,19,0,0,0,63,114,2008
Rhode Island,2,6,0,2,1,0,4,15,2008
South Carolina,73,4,72,0,0,0,20,169,2008
South Dakota,0,0,78,0,0,0,16,94,2008
Tennessee,34,3,25,0,0,0,42,104,2008
Texas,52,17,35,1,0,4,484,593,2008
Utah,7,60,5,0,1,0,22,95,2008
Vermont,2,1,0,2,1,0,5,11,2008
Virginia,22,9,6,1,0,0,19,57,2008
Washington,41,14,14,2,0,0,52,123,2008
West Virginia,1,1,3,0,0,0,5,10,2008
Wisconsin,1,18,113,0,0,0,41,173,2008
Wyoming,14,8,6,0,0,0,27,55,2008
Alabama,10,30,29, 596,0,2,69,736,2020
Alaska,0,1,0, 45,0,0,3,49,2020
Arizona,75,30,20, 1778,1,7,78,1989,2020
Arkansas,3,15,50, 350,0,1,36,455,2020
California,27,322,198, 34622,49,41,268,35527,2020
Colorado,7,34,88, 3234,1,0,53,3417,2020
Connecticut,1,18,3, 1240,2,0,19,1283,2020
Delaware,1,2,1, 206,1,0,9,220,2020
District of Columbia,7,2,3, 701,0,0,0,713,2020
Florida,10,55,94, 5519,0,3,113,5794,2020
Georgia,6,51,66, 3645,0,4,89,3861,2020
Hawaii,7,0,2, 760,2,1,1,773,2020
Idaho,0,11,5, 281,0,0,27,324,2020
Illinois,19,38,284, 2351,0,2,91,2785,2020
Indiana,3,32,234, 784,0,1,58,1112,2020
Iowa,10,12,315, 486,0,0,32,855,2020
Kansas,1,21,56, 950,0,1,37,1066,2020
Kentucky,3,9,72, 383,0,1,26,494,2020
Louisiana,1,22,18, 360,0,1,51,453,2020
Maine,2,2,0, 518,0,0,9,531,2020
Maryland,11,12,43, 2767,0,0,27,2860,2020
Massachusetts,10,13,7, 3406,1,1,30,3468,2020
Michigan,10,24,236, 1598,2,0,91,1961,2020
Minnesota,146,23,422, 1218,0,0,43,1852,2020
Mississippi,2,8,5, 344,0,2,76,437,2020
Missouri,2,20,115, 2060,0,1,71,2269,2020
Montana,1,1,1, 188,0,0,39,230,2020
Nebraska,3,10,88, 287,0,1,30,419,2020
Nevada,2,8,12, 1162,0,0,22,1206,2020
New Hampshire,2,4,0, 291,0,0,22,319,2020
New Jersey,4,28,6, 1651,0,0,13,1702,2020
New Mexico,3,11,14, 374,0,1,54,457,2020
New York,28,62,75, 6092,1,0,43,6301,2020
North Carolina,112,38,96, 2267,0,2,82,2597,2020
North Dakota,1,1,38, 101,0,0,24,165,2020
Ohio,12,54,193, 1840,1,3,75,2178,2020
Oklahoma,3,117,69, 693,0,0,122,1004,2020
Oregon,37,15,4, 2117,0,2,52,2227,2020
Pennsylvania,5,88,143, 2048,0,3,91,2378,2020
Rhode Island,4,3,0, 550,0,0,5,562,2020
South Carolina,34,11,49, 727,1,1,55,878,2020
South Dakota,0,0,80, 133,0,0,23,236,2020
Tennessee,9,21,89, 1341,0,4,61,1525,2020
Texas,26,112,241, 4802,0,16,427,5624,2020
Utah,0,48,2, 1617,0,0,43,1710,2020
Vermont,2,3,0, 797,0,0,1,803,2020
Virginia,10,23,61, 2504,0,2,83,2683,2020
Washington,36,25,16, 3771,1,1,82,3932,2020
West Virginia,0,3,37, 258,0,0,13,311,2020
Wisconsin,4,48,256, 829,0,1,64,1202,2020
Wyoming,0,8,10, 172,0,0,23,213,2020
Alabama,10,30,33, 680,0,2,68,823,2021
Alaska,0,1,0, 94,0,0,2,97,2021
Arizona,75,29,19, 2257,1,7,69,2457,2021
Arkansas,17,15,70, 453,0,0,35,590,2021
California,27,323,264, 41225,52,41,261,42193,2021
Colorado,6,31,96, 3978,1,1,50,4163,2021
Connecticut,1,17,3, 1430,1,0,20,1472,2021
Delaware,0,2,1, 314,1,0,9,327,2021
District of Columbia,8,2,4, 822,0,0,6,842,2021
Florida,7,56,111, 6723,0,3,139,7039,2021
Georgia,4,46,67, 3939,0,4,82,4142,2021
Hawaii,8,0,1, 833,2,0,1,845,2021
Idaho,0,11,5, 345,0,0,24,385,2021
Illinois,19,39,304, 2756,0,2,91,3211,2021
Indiana,7,31,247, 948,0,1,48,1282,2021
Iowa,12,11,342, 582,0,0,36,983,2021
Kansas,7,21,63, 1017,0,1,34,1143,2021
Kentucky,3,9,75, 527,0,1,20,635,2021
Louisiana,2,22,22, 385,0,1,50,482,2021
Maine,1,2,0, 629,0,0,8,640,2021
Maryland,27,15,46, 3416,0,0,33,3537,2021
Massachusetts,8,13,6, 4871,2,0,30,4930,2021
Michigan,10,23,245, 1833,2,0,87,2200,2021
Minnesota,157,23,454, 1390,0,0,49,2073,2021
Mississippi,1,6,4, 433,0,2,74,520,2021
Missouri,2,19,132, 2200,0,1,63,2417,2021
Montana,0,1,2, 212,0,0,28,243,2021
Nebraska,3,9,120, 377,0,1,27,537,2021
Nevada,2,5,12, 1353,0,0,23,1395,2021
New Hampshire,2,4,0, 351,0,0,18,375,2021
New Jersey,5,28,6, 2008,0,0,13,2060,2021
New Mexico,2,11,18, 457,0,1,54,543,2021
New York,30,57,79, 7621,1,0,46,7834,2021
North Carolina,110,37,100, 2784,0,1,70,3102,2021
North Dakota,1,1,49, 139,0,0,20,210,2021
Ohio,10,52,213, 2203,2,4,74,2558,2021
Oklahoma,1,116,88, 1088,0,0,118,1411,2021
Oregon,37,15,4, 2439,0,2,44,2541,2021
Pennsylvania,5,92,146, 2665,0,3,82,2993,2021
Rhode Island,3,1,0, 628,0,0,5,637,2021
South Carolina,33,11,46, 862,0,1,46,999,2021
South Dakota,0,0,83, 156,0,0,21,260,2021
Tennessee,9,20,95, 1647,0,4,55,1830,2021
Texas,18,107,269, 5486,0,15,383,6278,2021
Utah,1,42,1, 1978,0,1,36,2059,2021
Vermont,2,3,0, 871,0,0,1,877,2021
Virginia,7,23,64, 3301,1,1,85,3482,2021
Washington,25,24,14, 4328,1,1,78,4471,2021
West Virginia,1,2,38, 307,0,0,17,365,2021
Wisconsin,4,43,261, 949,0,1,52,1310,2021
Wyoming,0,9,9, 184,0,0,20,222,2021
Alabama,12,5,16,0,0,0,158,191,2009
Alaska,1,1,0,0,0,0,9,11,2009
Arizona,13,39,26,5,1,5,54,143,2009
Arkansas,7,5,10,0,0,0,41,63,2009
California,39,200,45,411,26,27,189,937,2009
Colorado,19,20,80,1,2,0,46,168,2009
Connecticut,1,12,4,0,2,0,12,31,2009
Delaware,3,1,1,0,0,0,2,7,2009
District of Columbia,1,2,3,0,1,0,0,7,2009
Florida,17,15,30,4,2,0,57,125,2009
Georgia,28,15,37,1,0,0,41,122,2009
Hawaii,5,0,0,3,1,0,3,12,2009
Idaho,8,7,5,5,0,1,25,51,2009
Illinois,5,23,204,6,1,0,72,311,2009
Indiana,7,7,112,0,0,0,43,169,2009
Iowa,3,0,124,0,0,0,26,153,2009
Kansas,6,3,31,0,0,0,45,85,2009
Kentucky,2,0,15,0,0,0,25,42,2009
Louisiana,1,6,5,0,0,0,14,26,2009
Maine,3,1,0,0,0,0,9,13,2009
Maryland,9,4,15,0,0,0,18,46,2009
Massachusetts,6,21,2,3,1,0,22,55,2009
Michigan,16,13,95,0,7,0,68,199,2009
Minnesota,0,1,351,2,0,0,27,381,2009
Mississippi,6,2,4,0,0,0,35,47,2009
Missouri,5,10,97,0,1,0,69,182,2009
Montana,6,3,1,0,0,0,43,53,2009
Nebraska,4,1,48,0,0,0,18,71,2009
Nevada,13,11,14,0,2,0,28,68,2009
New Hampshire,11,3,0,2,0,0,9,25,2009
New Jersey,3,14,2,2,0,0,10,31,2009
New Mexico,8,8,10,0,0,0,51,77,2009
New York,12,97,38,1,7,0,22,177,2009
North Carolina,138,14,19,3,0,0,53,227,2009
North Dakota,3,2,30,0,1,0,23,59,2009
Ohio,21,9,63,0,1,0,68,162,2009
Oklahoma,5,49,11,0,0,0,58,123,2009
Oregon,25,13,8,23,0,0,30,99,2009
Pennsylvania,12,22,26,0,2,0,65,127,2009
Rhode Island,2,5,0,0,0,0,5,12,2009
South Carolina,30,3,87,0,2,0,20,142,2009
South Dakota,2,0,78,0,0,0,16,96,2009
Tennessee,36,4,29,1,0,0,44,114,2009
Texas,20,20,41,3,0,4,541,629,2009
Utah,4,59,5,0,0,0,24,92,2009
Vermont,1,2,0,2,1,0,4,10,2009
Virginia,17,11,9,3,1,0,38,79,2009
Washington,47,15,15,3,0,0,64,144,2009
West Virginia,1,0,3,0,1,0,8,13,2009
Wisconsin,1,18,127,0,0,0,45,191,2009
Wyoming,15,7,6,0,0,0,23,51,2009
Alabama,10,27,34, 506,0,2,72,651,2019
Alaska,0,1,0, 34,0,0,5,40,2019
Arizona,78,30,22, 1476,1,8,75,1690,2019
Arkansas,3,16,47, 290,0,1,37,394,2019
California,29,321,195, 27128,48,44,273,28038,2019
Colorado,8,35,84, 2516,1,1,52,2697,2019
Connecticut,2,17,3, 1048,2,0,21,1093,2019
Delaware,1,2,1, 172,1,0,9,186,2019
District of Columbia,7,2,3, 553,1,0,0,566,2019
Florida,10,61,88, 4562,0,3,134,4858,2019
Georgia,6,50,52, 2939,0,4,89,3140,2019
Hawaii,7,0,2, 666,2,1,2,680,2019
Idaho,0,11,4, 216,0,0,30,261,2019
Illinois,19,42,279, 1864,0,2,100,2306,2019
Indiana,3,34,221, 614,0,1,65,938,2019
Iowa,11,11,300, 348,0,0,34,704,2019
Kansas,1,21,38, 904,0,1,37,1002,2019
Kentucky,3,10,71, 315,0,2,32,433,2019
Louisiana,2,23,14, 293,0,1,59,392,2019
Maine,4,1,1, 433,0,0,13,452,2019
Maryland,11,13,39, 2110,0,0,31,2204,2019
Massachusetts,10,15,6, 2455,2,1,32,2521,2019
Michigan,9,21,241, 1429,2,0,100,1802,2019
Minnesota,16,26,430, 1051,0,0,47,1570,2019
Mississippi,2,6,6, 292,0,2,83,391,2019
Missouri,2,20,111, 1895,0,1,73,2102,2019
Montana,3,1,1, 137,0,0,41,183,2019
Nebraska,3,8,97, 238,0,1,28,375,2019
Nevada,2,6,12, 927,0,1,28,976,2019
New Hampshire,2,4,0, 244,0,0,27,277,2019
New Jersey,4,27,6, 1297,0,0,17,1351,2019
New Mexico,3,11,14, 245,0,1,62,336,2019
New York,34,69,71, 4531,1,0,59,4765,2019
North Carolina,114,40,89, 1903,0,2,75,2223,2019
North Dakota,2,1,41, 46,0,0,24,114,2019
Ohio,13,60,180, 1342,1,5,90,1691,2019
Oklahoma,3,118,56, 309,0,1,130,617,2019
Oregon,47,16,9, 1893,0,2,57,2024,2019
Pennsylvania,5,88,125, 1475,0,3,107,1803,2019
Rhode Island,5,4,0, 407,0,0,4,420,2019
South Carolina,34,12,53, 643,1,1,59,803,2019
South Dakota,0,0,83, 127,0,0,23,233,2019
Tennessee,8,24,73, 1207,0,4,65,1381,2019
Texas,22,108,232, 4009,0,16,460,4847,2019
Utah,0,51,2, 950,0,2,39,1044,2019
Vermont,2,3,0, 664,0,0,1,670,2019
Virginia,10,24,58, 2056,0,2,88,2238,2019
Washington,37,24,20, 3206,1,1,82,3371,2019
West Virginia,0,3,34, 244,0,0,14,295,2019
Wisconsin,4,50,227, 711,0,1,66,1059,2019
Wyoming,0,8,11, 159,0,0,25,203,2019
Alabama,9,29,40, 395,0,3,82,558,2018
Alaska,0,1,0, 11,0,0,6,18,2018
Arizona,77,28,22, 1226,0,8,86,1447,2018
Arkansas,3,14,43, 124,0,1,39,224,2018
California,29,320,161, 21119,42,47,292,22010,2018
Colorado,13,41,81, 1792,1,1,57,1986,2018
Connecticut,2,21,4, 837,2,1,22,889,2018
Delaware,1,1,1, 133,1,0,8,145,2018
District of Columbia,7,2,3, 333,1,0,0,346,2018
Florida,14,56,88, 3030,0,3,139,3330,2018
Georgia,23,51,54, 2184,0,4,90,2406,2018
Hawaii,6,0,2, 536,5,1,4,554,2018
Idaho,0,11,6, 174,0,0,32,223,2018
Illinois,22,46,280, 1399,0,2,104,1853,2018
Indiana,5,33,211, 486,0,1,65,801,2018
Iowa,10,10,267, 296,0,0,33,616,2018
Kansas,1,22,26, 783,0,1,39,872,2018
Kentucky,3,10,74, 219,0,2,34,342,2018
Louisiana,6,23,12, 213,0,1,65,320,2018
Maine,3,2,1, 264,0,0,12,282,2018
Maryland,12,15,35, 1754,0,0,34,1850,2018
Massachusetts,12,15,7, 1790,2,1,33,1860,2018
Michigan,7,21,253, 1382,2,0,109,1774,2018
Minnesota,19,25,412, 788,0,0,48,1292,2018
Mississippi,4,6,5, 119,0,3,86,223,2018
Missouri,2,21,98, 1673,0,1,77,1872,2018
Montana,7,1,2, 96,0,0,45,151,2018
Nebraska,2,11,88, 194,0,1,34,330,2018
Nevada,2,5,14, 659,0,1,31,712,2018
New Hampshire,3,4,0, 228,0,0,30,265,2018
New Jersey,5,27,6, 747,0,0,16,801,2018
New Mexico,5,11,12, 181,0,1,63,273,2018
New York,34,74,72, 2560,1,0,66,2807,2018
North Carolina,111,39,86, 1490,0,1,91,1818,2018
North Dakota,3,1,44, 28,0,0,24,100,2018
Ohio,14,61,165, 949,2,5,95,1291,2018
Oklahoma,4,122,52, 167,0,1,135,481,2018
Oregon,65,16,10, 1544,0,2,61,1698,2018
Pennsylvania,6,80,123, 986,0,3,99,1297,2018
Rhode Island,5,4,0, 248,0,0,6,263,2018
South Carolina,24,11,66, 554,1,1,49,706,2018
South Dakota,1,0,77, 77,0,0,26,181,2018
Tennessee,21,23,78, 1145,0,5,71,1343,2018
Texas,16,119,220, 3134,1,21,457,3968,2018
Utah,1,70,2, 543,0,2,44,662,2018
Vermont,3,3,0, 535,0,0,1,542,2018
Virginia,9,22,47, 1451,0,2,82,1613,2018
Washington,39,23,20, 2571,1,1,86,2741,2018
West Virginia,2,3,33, 212,0,0,10,260,2018
Wisconsin,4,54,212, 557,0,1,72,900,2018
Wyoming,4,13,12, 121,0,0,29,179,2018
Alabama,5,29,31, 203,1,2,104,375,2015
Alaska,0,1,0, 3,0,0,7,11,2015
Arizona,76,38,30, 814,0,8,93,1059,2015
Arkansas,4,16,47, 65,0,0,50,182,2015
California,62,307,107, 10331,18,47,370,11242,2015
Colorado,16,42,89, 713,2,1,58,921,2015
Connecticut,3,17,4, 495,1,1,21,542,2015
Delaware,1,1,1, 55,1,0,8,67,2015
District of Columbia,7,2,3, 234,0,0,0,246,2015
Florida,17,51,74, 1710,0,1,153,2006,2015
Georgia,23,37,58, 1164,0,3,87,1372,2015
Hawaii,8,1,3, 493,2,0,4,511,2015
Idaho,3,10,7, 70,0,8,33,131,2015
Illinois,11,50,247, 920,1,1,127,1357,2015
Indiana,7,32,194, 296,0,1,190,720,2015
Iowa,10,10,214, 156,0,0,33,423,2015
Kansas,5,16,26, 551,0,1,41,640,2015
Kentucky,4,8,68, 93,0,1,50,224,2015
Louisiana,2,24,9, 82,0,2,43,162,2015
Maine,3,2,0, 87,0,0,16,108,2015
Maryland,9,12,34, 853,0,0,32,940,2015
Massachusetts,11,22,6, 959,1,1,36,1036,2015
Michigan,11,26,241, 786,2,0,112,1178,2015
Minnesota,6,22,289, 509,0,0,48,874,2015
Mississippi,4,8,3, 36,0,1,114,166,2015
Missouri,4,22,99, 526,0,0,69,720,2015
Montana,7,2,2, 45,0,0,57,113,2015
Nebraska,3,11,82, 57,0,0,27,180,2015
Nevada,4,8,20, 308,0,2,34,376,2015
New Hampshire,4,3,0, 131,0,0,18,156,2015
New Jersey,5,27,5, 408,0,0,20,465,2015
New Mexico,6,15,10, 97,0,1,58,187,2015
New York,36,87,85, 1281,1,0,80,1570,2015
North Carolina,130,43,26, 798,0,1,115,1113,2015
North Dakota,3,1,53, 5,0,0,24,86,2015
Ohio,12,54,136, 364,1,3,104,674,2015
Oklahoma,5,110,31, 79,0,1,136,362,2015
Oregon,25,15,8, 1103,0,3,51,1205,2015
Pennsylvania,6,60,37, 487,1,1,107,699,2015
Rhode Island,6,5,0, 178,0,0,8,197,2015
South Carolina,27,11,68, 328,2,1,56,493,2015
South Dakota,2,0,80, 24,0,0,23,129,2015
Tennessee,35,21,69, 863,0,0,98,1086,2015
Texas,21,116,197, 2024,1,16,489,2864,2015
Utah,1,92,3, 269,0,6,46,417,2015
Vermont,2,3,1, 275,0,0,4,285,2015
Virginia,9,21,18, 759,0,1,84,892,2015
Washington,30,24,21, 1588,0,1,92,1756,2015
West Virginia,2,3,9, 68,0,0,16,98,2015
Wisconsin,6,57,156, 376,0,1,74,670,2015
Wyoming,14,12,11, 32,0,0,29,98,2015
Alabama,6,25,32, 94,0,1,101,259,2014
Alaska,0,1,0, 1,0,0,6,8,2014
Arizona,78,36,30, 781,1,7,66,999,2014
Arkansas,4,13,43, 57,0,1,37,155,2014
California,85,284,94, 6990,22,46,237,7758,2014
Colorado,17,42,86, 453,1,0,48,647,2014
Connecticut,3,15,3, 359,1,1,17,399,2014
Delaware,1,1,1, 26,1,0,7,37,2014
District of Columbia,7,2,3, 134,0,0,0,146,2014
Florida,17,42,62, 1262,0,1,62,1446,2014
Georgia,24,30,52, 670,0,2,58,836,2014
Hawaii,9,1,3, 431,2,0,3,449,2014
Idaho,4,10,8, 23,0,8,25,78,2014
Illinois,12,49,234, 799,1,1,104,1200,2014
Indiana,6,28,188, 231,0,2,174,629,2014
Iowa,9,6,210, 109,0,0,19,353,2014
Kansas,7,12,25, 184,0,0,35,263,2014
Kentucky,4,5,62, 106,0,1,47,225,2014
Louisiana,2,24,8, 68,0,1,33,136,2014
Maine,3,2,0, 41,0,0,15,61,2014
Maryland,8,11,34, 650,0,0,20,723,2014
Massachusetts,12,24,9, 721,1,0,21,788,2014
Michigan,16,23,220, 706,4,0,81,1050,2014
Minnesota,10,17,278, 446,0,0,29,780,2014
Mississippi,4,8,3, 35,0,0,111,161,2014
Missouri,5,18,101, 194,1,0,62,381,2014
Montana,6,2,2, 10,0,0,50,70,2014
Nebraska,5,11,80, 40,0,0,24,160,2014
Nevada,5,9,21, 258,1,4,32,330,2014
New Hampshire,4,3,1, 65,0,0,15,88,2014
New Jersey,5,25,5, 262,0,0,9,306,2014
New Mexico,8,14,14, 59,0,1,44,140,2014
New York,37,114,83, 1038,7,0,57,1336,2014
North Carolina,133,39,23, 682,0,0,90,967,2014
North Dakota,3,1,77, 4,0,0,19,104,2014
Ohio,17,45,128, 239,2,2,68,501,2014
Oklahoma,6,100,25, 46,0,1,143,321,2014
Oregon,25,15,7, 989,0,1,34,1071,2014
Pennsylvania,6,46,33, 381,2,0,74,542,2014
Rhode Island,6,6,0, 149,0,0,5,166,2014
South Carolina,41,9,71, 247,2,1,45,416,2014
South Dakota,2,0,82, 32,0,0,18,134,2014
Tennessee,37,18,66, 924,0,2,91,1138,2014
Texas,17,97,136, 1839,1,10,441,2541,2014
Utah,3,89,3, 144,0,7,24,270,2014
Vermont,1,3,1, 122,0,0,2,129,2014
Virginia,11,23,17, 593,1,0,74,719,2014
Washington,31,23,21, 1486,0,1,70,1632,2014
West Virginia,2,3,9, 101,0,0,12,127,2014
Wisconsin,6,60,136, 304,0,1,54,561,2014
Wyoming,13,11,10, 17,0,0,18,69,2014
Alabama,5,32,32, 227,0,2,92,390,2016
Alaska,0,1,0, 5,0,0,7,13,2016
Arizona,76,36,25, 1016,0,8,93,1254,2016
Arkansas,5,17,44, 91,0,1,45,203,2016
California,42,319,119, 14084,39,44,322,14969,2016
Colorado,16,46,88, 990,1,1,59,1201,2016
Connecticut,3,19,4, 723,2,1,22,774,2016
Delaware,1,1,1, 67,1,0,9,80,2016
District of Columbia,8,3,4, 242,1,0,0,258,2016
Florida,14,57,74, 2128,0,3,153,2429,2016
Georgia,24,48,56, 1508,0,4,96,1736,2016
Hawaii,8,1,2, 566,4,0,6,587,2016
Idaho,2,11,6, 134,0,6,34,193,2016
Illinois,12,56,263, 1136,1,2,123,1593,2016
Indiana,6,35,200, 389,0,2,189,821,2016
Iowa,9,10,210, 216,0,0,35,480,2016
Kansas,5,20,21, 725,0,1,41,813,2016
Kentucky,4,11,72, 168,0,1,38,294,2016
Louisiana,2,22,11, 155,0,2,50,242,2016
Maine,3,2,0, 184,0,0,15,204,2016
Maryland,11,16,34, 1133,0,1,32,1227,2016
Massachusetts,12,18,7, 1256,2,1,35,1331,2016
Michigan,10,27,254, 1134,2,0,108,1535,2016
Minnesota,7,25,314, 686,0,0,51,1083,2016
Mississippi,4,5,3, 64,0,2,97,175,2016
Missouri,3,22,92, 1163,0,1,68,1349,2016
Montana,7,1,2, 76,0,0,55,141,2016
Nebraska,1,11,80, 116,0,1,28,237,2016
Nevada,4,6,20, 491,0,2,34,557,2016
New Hampshire,4,3,0, 184,0,0,21,212,2016
New Jersey,5,28,5, 506,0,0,21,565,2016
New Mexico,5,14,10, 135,0,1,55,220,2016
New York,35,114,79, 1630,1,0,77,1936,2016
North Carolina,122,40,58, 1039,0,1,106,1366,2016
North Dakota,3,0,43, 9,0,0,25,80,2016
Ohio,14,59,151, 522,1,6,103,856,2016
Oklahoma,5,125,29, 103,0,1,144,407,2016
Oregon,54,17,10, 1271,0,3,61,1416,2016
Pennsylvania,7,68,41, 674,1,3,103,897,2016
Rhode Island,6,5,0, 204,0,0,7,222,2016
South Carolina,25,12,67, 376,1,1,53,535,2016
South Dakota,2,1,75, 40,0,0,27,145,2016
Tennessee,32,19,79, 993,0,5,88,1216,2016
Texas,17,132,193, 2440,1,20,487,3290,2016
Utah,1,90,1, 298,0,8,48,446,2016
Vermont,3,3,1, 389,0,0,2,398,2016
Virginia,11,21,22, 995,0,2,88,1139,2016
Washington,40,27,21, 1833,0,2,90,2013,2016
West Virginia,2,4,11, 96,0,0,13,126,2016
Wisconsin,5,57,151, 451,0,1,69,734,2016
Wyoming,14,13,10, 63,0,0,29,129,2016
Alabama,5,33,39, 320,0,3,89,489,2017
Alaska,0,1,0, 11,0,0,7,19,2017
Arizona,76,30,21, 1066,0,8,89,1290,2017
Arkansas,4,16,43, 113,0,1,40,217,2017
California,36,324,147, 16538,42,44,295,17426,2017
Colorado,16,42,91, 1383,1,1,56,1590,2017
Connecticut,2,21,4, 788,2,1,20,838,2017
Delaware,1,1,1, 102,1,0,9,115,2017
District of Columbia,7,2,3, 259,1,0,0,272,2017
Florida,14,58,82, 2505,0,3,140,2802,2017
Georgia,23,48,53, 1900,0,4,92,2120,2017
Hawaii,8,1,2, 626,4,0,5,646,2017
Idaho,2,11,5, 170,0,2,31,221,2017
Illinois,14,47,270, 1236,1,2,121,1691,2017
Indiana,6,34,204, 403,0,1,185,833,2017
Iowa,9,9,247, 258,0,0,33,556,2017
Kansas,3,23,20, 742,0,1,38,827,2017
Kentucky,5,12,73, 193,0,2,36,321,2017
Louisiana,7,25,12, 195,0,1,75,315,2017
Maine,3,2,0, 221,0,0,14,240,2017
Maryland,13,17,36, 1341,0,1,34,1442,2017
Massachusetts,11,16,7, 1503,2,1,34,1574,2017
Michigan,9,23,254, 1210,2,0,103,1601,2017
Minnesota,7,25,372, 760,0,0,48,1212,2017
Mississippi,4,7,5, 116,0,2,91,225,2017
Missouri,3,22,94, 1570,0,1,69,1759,2017
Montana,7,1,2, 84,0,0,48,142,2017
Nebraska,2,11,95, 159,0,1,27,295,2017
Nevada,4,6,19, 614,0,1,31,675,2017
New Hampshire,4,4,0, 195,0,0,29,232,2017
New Jersey,5,26,4, 575,0,0,19,629,2017
New Mexico,5,14,11, 167,0,1,59,257,2017
New York,34,84,72, 1966,1,0,71,2228,2017
North Carolina,115,43,79, 1374,0,1,92,1704,2017
North Dakota,2,1,41, 15,0,0,24,83,2017
Ohio,14,59,164, 775,3,6,92,1113,2017
Oklahoma,5,120,32, 137,0,2,135,431,2017
Oregon,70,16,10, 1363,0,2,57,1518,2017
Pennsylvania,7,77,75, 778,0,3,104,1044,2017
Rhode Island,6,4,0, 216,0,0,6,232,2017
South Carolina,24,13,64, 489,2,1,49,642,2017
South Dakota,2,1,77, 47,0,0,25,152,2017
Tennessee,27,22,81, 1057,0,6,78,1271,2017
Texas,18,127,215, 2719,1,23,470,3573,2017
Utah,1,79,1, 388,0,6,46,521,2017
Vermont,2,3,0, 435,0,0,2,442,2017
Virginia,10,23,31, 1103,0,2,92,1261,2017
Washington,41,25,19, 2145,0,2,88,2320,2017
West Virginia,2,3,33, 199,0,0,10,247,2017
Wisconsin,5,56,157, 497,0,1,74,790,2017
Wyoming,4,14,12, 91,0,0,28,149,2017
Alabama,2,1,0,0,0,0,7,10,2013
Alaska,10,21,29,50,0,2,113,225,2013
Arizona,5,8,30,38,0,0,39,120,2013
Arkansas,79,32,31,710,1,6,62,921,2013
California,84,258,88,5176,21,43,233,5903,2013
Colorado,19,36,85,256,1,0,52,449,2013
Connecticut,2,16,1,217,2,1,15,254,2013
Delaware,1,1,1,20,0,0,4,27,2013
District of Columbia,7,2,3,62,0,0,0,74,2013
Florida,17,33,54,996,0,0,65,1165,2013
Georgia,25,25,61,370,0,1,57,539,2013
Hawaii,9,1,3,351,3,0,3,370,2013
Idaho,7,4,186,87,0,0,21,305,2013
Illinois,6,8,9,13,0,5,25,66,2013
Indiana,11,40,218,527,1,0,102,899,2013
Iowa,7,20,169,183,0,1,174,554,2013
Kansas,7,6,28,109,0,0,36,186,2013
Kentucky,4,4,55,45,0,0,47,155,2013
Louisiana,2,20,4,53,0,1,34,114,2013
Maine,12,23,8,546,1,0,17,607,2013
Maryland,9,9,25,553,0,0,17,613,2013
Massachusetts,3,1,1,24,0,0,12,41,2013
Michigan,19,19,163,721,4,0,73,999,2013
Minnesota,11,11,336,235,0,0,33,626,2013
Mississippi,4,12,106,146,1,0,64,333,2013
Missouri,4,5,1,37,0,0,125,172,2013
Montana,6,2,4,2,0,0,45,59,2013
Nebraska,135,36,22,524,0,0,97,814,2013
Nevada,3,1,58,4,0,0,18,84,2013
New Hampshire,3,9,75,28,0,0,22,137,2013
New Jersey,5,3,0,40,0,0,10,58,2013
New Mexico,5,29,5,219,0,0,10,268,2013
New York,8,11,13,33,0,0,45,110,2013
North Carolina,6,7,20,107,1,2,39,182,2013
North Dakota,38,111,81,693,9,0,63,995,2013
Ohio,19,25,97,175,1,2,66,385,2013
Oklahoma,5,94,27,32,0,0,149,307,2013
Oregon,24,14,8,915,0,0,34,995,2013
Pennsylvania,7,51,33,263,2,0,73,429,2013
Rhode Island,7,6,1,143,0,0,6,163,2013
South Carolina,60,10,82,218,2,1,44,417,2013
South Dakota,2,0,87,13,0,0,17,119,2013
Tennessee,44,9,52,866,0,0,102,1073,2013
Texas,20,62,81,1599,1,10,458,2231,2013
Utah,3,88,3,72,0,7,27,200,2013
Vermont,12,20,19,370,1,0,58,480,2013
Virginia,2,3,1,51,0,0,3,60,2013
Washington,33,24,24,1325,1,1,68,1476,2013
West Virginia,4,45,115,211,0,1,54,430,2013
Wisconsin,2,3,4,42,0,0,12,63,2013
Wyoming,13,11,9,2,0,0,17,52,2013
Alabama,11,3,6,0,0,0,40,60,2007
Alaska,0,1,0,0,0,0,10,11,2007
Arizona,10,40,23,5,1,5,51,135,2007
Arkansas,2,3,7,0,0,0,37,49,2007
California,36,184,13,376,26,28,199,862,2007
Colorado,18,18,65,0,0,0,43,144,2007
Connecticut,1,9,4,3,1,0,13,31,2007
Delaware,3,1,1,0,0,0,2,7,2007
District of Columbia,1,1,3,0,1,0,0,6,2007
Florida,12,15,18,3,2,0,47,97,2007
Georgia,28,18,28,0,0,0,37,111,2007
Hawaii,7,0,0,4,1,0,3,15,2007
Idaho,6,7,5,0,0,1,25,44,2007
Illinois,3,20,181,5,1,0,52,262,2007
Indiana,6,14,111,0,0,0,31,162,2007
Iowa,5,0,107,0,0,0,24,136,2007
Kansas,5,2,23,0,0,0,44,74,2007
Kentucky,1,0,11,0,0,0,13,25,2007
Louisiana,1,5,3,0,0,0,9,18,2007
Maine,5,1,0,0,0,0,8,14,2007
Maryland,8,14,12,0,0,0,13,47,2007
Massachusetts,5,11,1,12,1,0,21,51,2007
Michigan,17,13,60,0,7,0,69,166,2007
Minnesota,1,1,353,0,0,0,30,385,2007
Mississippi,5,0,2,0,0,0,33,40,2007
Missouri,5,6,87,0,1,0,65,164,2007
Montana,4,3,1,0,0,0,29,37,2007
Nebraska,3,2,35,0,0,0,18,58,2007
Nevada,12,11,16,0,2,0,28,69,2007
New Hampshire,11,3,0,8,0,0,11,33,2007
New Jersey,1,11,0,0,0,0,10,22,2007
New Mexico,7,11,8,0,1,0,49,76,2007
New York,5,92,17,1,0,0,30,145,2007
North Carolina,66,12,14,0,0,0,44,136,2007
North Dakota,0,2,30,0,1,0,13,46,2007
Ohio,24,8,64,0,0,0,66,162,2007
Oklahoma,6,51,6,0,0,0,64,127,2007
Oregon,36,12,8,15,2,0,29,102,2007
Pennsylvania,7,25,19,0,0,0,63,114,2007
Rhode Island,2,6,0,2,1,0,4,15,2007
South Carolina,73,4,72,0,0,0,20,169,2007
South Dakota,0,0,78,0,0,0,16,94,2007
Tennessee,34,3,25,0,0,0,42,104,2007
Texas,52,17,35,1,0,4,484,593,2007
Utah,7,60,5,0,1,0,22,95,2007
Vermont,2,1,0,2,1,0,5,11,2007
Virginia,22,9,6,1,0,0,19,57,2007
Washington,41,14,14,2,0,0,52,123,2007
West Virginia,1,1,3,0,0,0,5,10,2007
Wisconsin,1,18,113,0,0,0,41,173,2007
Wyoming,14,8,6,0,0,0,27,55,2007
Alabama,0,1,0,4,0,0,7,12,2012
Alaska,11,15,28,48,0,2,94,198,2012
Arizona,4,5,33,36,0,0,44,122,2012
Arkansas,20,33,32,527,1,6,63,682,2012
California,69,256,71,3573,24,41,227,4261,2012
Colorado,21,36,84,206,1,0,59,407,2012
Connecticut,2,16,1,150,2,1,15,187,2012
Delaware,1,1,1,14,0,0,3,20,2012
District of Columbia,2,2,3,105,0,0,0,112,2012
Florida,15,28,51,862,0,0,68,1024,2012
Georgia,26,23,59,193,0,0,46,347,2012
Hawaii,8,1,3,315,3,0,3,333,2012
Idaho,7,2,188,72,0,0,20,289,2012
Illinois,7,8,9,11,0,0,27,62,2012
Indiana,10,36,206,471,1,0,97,821,2012
Iowa,8,15,157,166,0,0,181,527,2012
Kansas,7,6,32,67,0,0,36,148,2012
Kentucky,3,4,35,36,0,0,43,121,2012
Louisiana,2,18,4,61,0,1,21,107,2012
Maine,6,20,8,414,1,0,20,469,2012
Maryland,9,9,22,406,0,0,18,464,2012
Massachusetts,4,1,1,21,0,0,9,36,2012
Michigan,18,19,129,651,4,0,75,896,2012
Minnesota,9,8,360,150,0,0,37,564,2012
Mississippi,4,11,110,120,1,0,64,310,2012
Missouri,3,2,1,38,0,0,138,182,2012
Montana,6,2,3,2,0,0,41,54,2012
Nebraska,137,30,30,465,0,0,64,726,2012
Nevada,3,2,79,4,0,0,18,106,2012
New Hampshire,3,8,77,8,0,0,22,118,2012
New Jersey,3,3,0,42,0,0,11,59,2012
New Mexico,5,27,5,188,0,0,10,235,2012
New York,8,10,14,31,0,0,49,112,2012
North Carolina,5,7,19,55,2,1,39,128,2012
North Dakota,21,111,84,520,9,0,35,780,2012
Ohio,21,24,88,149,1,1,71,355,2012
Oklahoma,5,91,27,26,0,0,54,203,2012
Oregon,25,14,8,775,0,0,33,855,2012
Pennsylvania,7,40,32,217,2,0,70,368,2012
Rhode Island,2,6,0,41,0,0,6,55,2012
South Carolina,33,7,84,210,2,0,34,370,2012
South Dakota,2,0,100,9,0,0,17,128,2012
Tennessee,44,8,43,738,0,0,75,908,2012
Texas,17,52,80,1310,1,9,471,1940,2012
Utah,3,88,4,67,0,3,26,191,2012
Vermont,14,16,18,300,2,0,58,408,2012
Virginia,1,3,1,28,0,0,4,37,2012
Washington,37,23,20,1068,1,0,72,1221,2012
West Virginia,4,31,126,185,0,1,51,398,2012
Wisconsin,2,0,4,37,0,0,9,52,2012
Wyoming,12,11,9,0,0,0,21,53,2012
Alabama,5,4,15,0,0,1,128,153,2010
Alaska,1,2,0,0,0,0,8,11,2010
Arizona,14,36,32,8,1,5,61,157,2010
Arkansas,6,4,13,1,0,0,51,75,2010
California,35,213,54,428,22,32,227,1011,2010
Colorado,14,23,86,5,1,0,50,179,2010
Connecticut,1,13,1,4,2,0,16,37,2010
Delaware,3,1,1,0,0,0,3,8,2010
District of Columbia,1,2,3,1,1,0,0,8,2010
Florida,16,14,42,7,0,0,75,154,2010
Georgia,26,18,41,1,0,0,47,133,2010
Hawaii,5,0,1,7,1,0,3,17,2010
Idaho,8,8,7,5,0,1,29,58,2010
Illinois,5,25,219,19,1,0,72,341,2010
Indiana,7,10,138,0,0,0,47,202,2010
Iowa,3,0,144,6,0,0,20,173,2010
Kansas,6,2,39,0,0,0,37,84,2010
Kentucky,2,0,21,0,0,0,44,67,2010
Louisiana,1,7,5,0,0,0,16,29,2010
Maine,3,1,0,0,0,0,5,9,2010
Maryland,9,5,19,2,0,0,22,57,2010
Massachusetts,6,22,3,3,1,0,22,57,2010
Michigan,15,14,109,11,5,0,67,221,2010
Minnesota,0,1,360,2,0,0,33,396,2010
Mississippi,5,2,3,0,0,0,40,50,2010
Missouri,3,9,103,1,1,0,76,193,2010
Montana,6,3,2,0,0,0,53,64,2010
Nebraska,3,1,58,0,0,0,17,79,2010
Nevada,6,11,26,1,2,0,43,89,2010
New Hampshire,11,3,0,4,0,0,7,25,2010
New Jersey,4,20,4,4,0,0,10,42,2010
New Mexico,7,10,11,0,0,0,54,82,2010
New York,16,101,75,9,10,0,27,238,2010
North Carolina,141,16,20,5,0,0,72,254,2010
North Dakota,3,2,55,0,1,0,24,85,2010
Ohio,21,11,67,1,1,0,68,169,2010
Oklahoma,5,50,13,0,0,0,58,126,2010
Oregon,24,12,8,36,0,0,32,112,2010
Pennsylvania,6,24,37,1,2,0,70,140,2010
Rhode Island,2,5,0,1,0,0,5,13,2010
South Carolina,30,5,101,1,2,0,26,165,2010
South Dakota,2,0,101,0,0,0,18,121,2010
Tennessee,49,5,39,1,0,0,76,170,2010
Texas,17,30,48,26,1,4,520,646,2010
Utah,2,72,5,0,0,0,30,109,2010
Vermont,2,2,0,2,1,0,6,13,2010
Virginia,15,11,11,3,1,0,37,78,2010
Washington,28,15,15,15,0,0,69,142,2010
West Virginia,1,1,3,0,1,0,8,14,2010
Wisconsin,0,16,132,5,0,0,50,203,2010
Wyoming,14,7,6,0,0,0,25,52,2010
Alabama,0,1,0,0,0,0,8,9,2011
Alaska,6,11,20,4,0,1,106,148,2011
Arizona,5,6,20,11,0,0,49,91,2011
Arkansas,14,30,33,43,1,1,67,189,2011
California,48,224,58,1392,23,34,227,2006,2011
Colorado,14,29,83,33,1,0,53,213,2011
Connecticut,3,13,0,40,2,1,16,75,2011
Delaware,1,1,1,0,0,0,3,6,2011
District of Columbia,2,2,3,51,0,0,0,58,2011
Florida,15,15,62,357,0,0,71,520,2011
Georgia,25,17,51,44,0,0,57,194,2011
Hawaii,8,0,1,60,1,0,3,73,2011
Idaho,3,0,167,24,0,0,21,215,2011
Illinois,9,8,9,19,0,0,29,74,2011
Indiana,8,27,218,170,1,0,67,491,2011
Iowa,4,9,153,9,0,0,52,227,2011
Kansas,6,4,40,13,0,0,38,101,2011
Kentucky,4,1,29,0,0,0,41,75,2011
Louisiana,2,9,2,12,0,0,22,47,2011
Maine,7,20,4,60,1,0,21,113,2011
Maryland,7,6,23,167,0,0,17,220,2011
Massachusetts,3,1,0,0,0,0,7,11,2011
Michigan,16,16,122,355,4,0,65,578,2011
Minnesota,3,2,364,69,0,0,38,476,2011
Mississippi,4,9,106,36,1,0,68,224,2011
Missouri,3,1,2,6,0,0,39,51,2011
Montana,6,2,1,0,0,0,46,55,2011
Nebraska,143,22,29,152,0,0,63,409,2011
Nevada,2,2,74,0,1,0,18,97,2011
New Hampshire,2,3,68,0,0,0,19,92,2011
New Jersey,5,4,0,15,0,0,12,36,2011
New Mexico,3,23,4,70,0,0,10,110,2011
New York,6,10,9,6,0,0,50,81,2011
North Carolina,5,11,23,27,2,0,41,109,2011
North Dakota,24,105,82,226,9,0,34,480,2011
Ohio,21,15,84,37,1,0,65,223,2011
Oklahoma,6,63,15,0,0,0,56,140,2011
Oregon,26,12,9,313,0,0,32,392,2011
Pennsylvania,8,29,35,33,2,0,69,176,2011
Rhode Island,2,5,0,5,0,0,6,18,2011
South Carolina,30,5,100,82,2,0,27,246,2011
South Dakota,1,0,102,0,0,0,17,120,2011
Tennessee,44,6,44,126,0,0,74,294,2011
Texas,14,35,58,388,1,5,491,992,2011
Utah,5,72,4,13,0,1,29,124,2011
Vermont,12,11,15,90,1,0,56,185,2011
Virginia,1,3,0,8,1,0,5,18,2011
Washington,32,15,19,438,0,0,67,571,2011
West Virginia,2,17,140,60,0,0,48,267,2011
Wisconsin,0,1,3,6,1,0,9,20,2011
Wyoming,13,8,5,0,0,0,22,48,2011
